심곤탐	남
설누람	남
송래자	남
우잔일	남
노균식	남
마장노	남
은개대	남
정별길	남
탁별면	여
나롱도	남
국전울	남
윤솜환	남
권롱두	남
표고달	남
왕영비	남
엄석문	남
모울나	남
곽택하	여
전누악	여
왕분걸	남
진은온	여
석걸타	남
방반덕	여
정완학	여
홍조다	여
진솔공	남
전식윤	남
탁위산	남
나여림	여
표연휘	남
장관언	여
윤세진	여
금나두	남
국흠범	여
옥심직	여
강마량	여
소모준	여
표학향	여
소식성	남
기박빛	여
나향규	남
주혜도	남
양루선	여
오장용	여
주희학	여
구직혼	여
홍백세	남
용리율	여
국조환	남
박수추	남
고흔위	남
송별솔	여
백옥리	여
황환소	남
진윤순	여
반순비	여
여솜란	남
박완사	남
여림숭	남
안규휘	여
배린술	여
차란기	여
여복초	여
전정세	여
금형뜸	남
추선원	남
위노조	여
배범유	여
배석상	여
현늘산	남
하영모	남
강담세	여
남량담	남
조엽요	여
전탐용	여
원온려	여
손의애	남
이량진	여
유슬번	여
표철일	남
조훈현	남
석마더	남
강흔문	여
구루장	여
진일슬	여
오종정	남
오직선	남
양롱중	남
장새아	남
염누찬	남
염지송	여
박다슬	여
신엄월	남
반련더	남
주랑단	남
진한롱	여
금탁위	여
변루창	여
국악웅	여
위배빈	남
천휴홍	여
여권설	여
남종타	남
옥사보	남
신설조	여
장라휴	여
국빛백	남
신울성	남
노휴윤	여
왕초솜	여
구진비	남
용건권	여
민조을	여
변흥욱	여
위월흥	여
임별홍	남
표복삼	남
추창늘	여
채현심	남
제모연	여
설우직	남
하엽경	여
임상변	남
나라식	남
민성우	남
신석복	여
방추화	남
왕보변	남
왕빛담	여
소춘배	여
전남태	남
위효후	여
어번추	남
민철길	여
고인정	여
고연면	여
방도연	여
조숙이	남
원일하	여
변디권	남
고무운	여
위기판	여
선시선	남
인원라	남
신용춘	여
장승반	여
설천덕	여
소홍섬	남
조잎송	남
손안헌	남
지용얀	여
홍판량	여
변해호	여
권훔견	남
권무미	여
용혁혼	남
선래연	여
연춘섬	여
염출다	남
구려얀	남
방번은	여
채조엽	남
어배재	남
엄황겸	남
유번바	여
육복실	남
박화윤	남
옥승엽	여
심늬건	남
심뜸예	여
방후찬	여
민균모	여
오성혁	남
성규월	여
추우실	남
황판반	남
홍병양	여
허명실	남
조악잎	여
민평현	남
문슬태	여
편문린	남
한늘심	여
심고순	여
은타환	남
성예직	여
변문노	남
배태의	남
주비실	여
송신잎	여
주예악	여
정월덕	남
용남윤	남
김여세	남
연설바	여
송항혜	남
설숙현	남
이의으	여
염건회	남
신을민	남
위충혼	여
염보시	여
지조단	여
위봉열	남
류휴대	여
원균비	남
신디출	여
박아헌	남
유바근	여
천항환	여
엄자늬	남
제미란	여
문으설	남
권병조	남
원향준	남
구뜸모	남
채란린	여
곽흠중	남
한부박	남
엄뜸섭	남
한운변	남
함철대	여
방솔향	여
김태영	남
유여추	남
편루노	여
권아요	남
조한려	남
금건관	남
용유학	남
류황여	남
위선흔	여
권유광	여
석솔량	남
염모상	남
허근시	남
성언리	여
임예면	남
어오령	남
천루슬	여
송개마	남
차철찬	여
조수솜	여
변범근	남
박울견	남
강담추	여
정율단	여
나보백	여
선나익	여
황인관	여
황장회	남
이란섭	남
제채경	남
전태찬	여
최래안	여
류제면	남
육늘양	여
위으재	여
현재마	남
석유춘	여
남회기	여
정창미	남
백탁채	여
이병경	여
정헌석	여
구량효	남
구희관	여
공고심	남
노환태	남
길묵나	남
곽호의	여
국새추	여
용근창	여
주언련	여
진화효	남
유승범	여
위무항	남
윤손누	남
진중악	여
장새시	여
장추섬	여
신제형	남
송심누	여
송철주	남
우남흥	남
민엽탐	남
우월시	여
임두중	남
한동평	여
임다영	여
류채뜸	여
신희찬	여
모이추	여
마웅희	여
구묵창	여
오엽숙	남
우재늘	여
채개완	여
류전하	남
은회부	여